#########
#.......#
#.#####.#
#.#   #.#
#.#   #.#
#.#   #.#
#.#####.#
#.......#
#########